,date,decideCnt,deathCnt,careCnt,clearCnt,examCnt,resutlNegCnt,accDecideCnt,accDeathCnt,accClearCnt,accExamCnt,accExamCompCnt,accDefRate
0,2020-01-20,1,0,1,0,0,3,1,0,0,4,4,25.0
1,2020-01-21,0,0,1,0,0,14,1,0,0,15,15,6.666666667
2,2020-01-22,0,0,1,0,0,20,1,0,0,21,21,4.761904762
3,2020-01-23,0,0,1,0,0,24,1,0,0,25,25,4.0
4,2020-01-24,1,0,2,0,0,27,2,0,0,29,29,6.896551724
5,2020-01-25,0,0,2,0,0,45,2,0,0,47,47,4.255319149
6,2020-01-26,1,0,3,0,0,53,3,0,0,56,56,5.357142857
7,2020-01-27,1,0,4,0,0,80,4,0,0,84,84,4.761904762
8,2020-01-28,0,0,4,0,0,133,4,0,0,137,137,2.919708029
9,2020-01-29,0,0,4,0,0,204,4,0,0,208,208,1.923076923
10,2020-01-30,3,0,7,0,0,268,7,0,0,275,275,2.545454545
11,2020-01-31,4,0,11,0,0,324,11,0,0,335,335,3.28358209
12,2020-02-01,1,0,12,0,0,359,12,0,0,371,371,3.234501348
13,2020-02-02,3,0,15,0,0,414,15,0,0,429,429,3.496503497
14,2020-02-03,0,0,15,0,0,475,15,0,0,490,490,3.06122449
15,2020-02-04,1,0,16,0,0,591,16,0,0,607,607,2.635914333
16,2020-02-05,5,0,21,0,40,653,21,0,0,714,674,3.115727003
17,2020-02-06,3,0,24,0,169,692,24,0,0,885,716,3.351955307
18,2020-02-07,0,0,22,2,327,779,24,0,2,1130,803,2.98879203
19,2020-02-08,0,0,22,0,620,1057,24,0,2,1701,1081,2.220166512
20,2020-02-09,3,0,25,0,888,1425,27,0,2,2340,1452,1.859504132
21,2020-02-10,1,0,25,1,531,2217,28,0,3,2776,2245,1.247216036
22,2020-02-11,0,0,24,1,762,2839,28,0,4,3629,2867,0.976630624
23,2020-02-12,0,0,24,0,785,4261,28,0,4,5074,4289,0.652832828
24,2020-02-13,0,0,21,3,562,5207,28,0,7,5797,5235,0.534861509
25,2020-02-14,0,0,21,0,535,6291,28,0,7,6854,6319,0.443108087
26,2020-02-15,0,0,21,0,558,6933,28,0,7,7519,6961,0.402241057
27,2020-02-16,2,0,21,2,485,7404,30,0,9,7919,7434,0.403551251
28,2020-02-17,0,0,21,0,708,7433,30,0,9,8171,7463,0.401983117
29,2020-02-18,2,0,22,1,818,8415,32,0,10,9265,8447,0.378832722
30,2020-02-19,34,0,54,2,1149,9196,66,0,12,10411,9262,0.712589074
31,2020-02-20,16,1,65,4,1860,10219,82,1,16,12161,10301,0.796039219
32,2020-02-21,74,0,139,0,3180,11480,156,1,16,14816,11636,1.340666896
33,2020-02-22,190,2,326,1,6037,13238,346,3,17,19621,13584,2.547114252
34,2020-02-23,210,0,536,0,8057,14020,556,3,17,22633,14576,3.814489572
35,2020-02-24,207,4,739,0,11631,16221,763,7,17,28615,16984,4.492463495
36,2020-02-25,130,1,864,4,13880,21943,893,8,21,36716,22836,3.910492205
37,2020-02-26,253,3,1114,0,20716,24265,1146,11,21,46127,25411,4.509857936
38,2020-02-27,449,1,1560,2,25568,30827,1595,12,23,57990,32422,4.919499106
39,2020-02-28,427,1,1984,2,30237,38681,2022,13,25,70940,40703,4.967692799
40,2020-02-29,909,3,2889,1,35182,47580,2931,16,26,85693,50511,5.802696442
41,2020-03-01,595,1,3481,2,33360,60099,3526,17,28,96985,63625,5.541846758
42,2020-03-02,686,6,4159,2,33799,71580,4212,23,30,109591,75792,5.557314756
43,2020-03-03,600,5,4750,4,35555,85484,4812,28,34,125851,90296,5.329139718
44,2020-03-04,516,4,5256,6,28414,102965,5328,32,40,136707,108293,4.919985595
45,2020-03-05,438,3,5645,46,21810,118965,5766,35,86,146541,124731,4.622748154
46,2020-03-06,518,7,6136,20,21832,136624,6284,42,106,164740,142908,4.397234584
47,2020-03-07,483,2,6608,9,19620,151802,6767,44,115,178189,158569,4.267542836
48,2020-03-08,367,6,6958,11,19376,162008,7134,50,126,188518,169142,4.21775786
49,2020-03-09,248,1,7172,33,17458,171778,7382,51,159,196618,179160,4.120339361
50,2020-03-10,131,3,7227,73,18452,184179,7513,54,232,210144,191692,3.919308057
51,2020-03-11,242,6,7423,40,18540,196100,7755,60,272,222395,203855,3.804174536
52,2020-03-12,114,6,7485,46,17727,209402,7869,66,318,234998,217271,3.621744273
53,2020-03-13,110,1,7422,172,17940,222728,7979,67,490,248647,230707,3.458499309
54,2020-03-14,107,5,7324,200,17634,235615,8086,72,690,261335,243701,3.318000336
55,2020-03-15,76,3,7280,117,16272,243778,8162,75,807,268212,251940,3.239660237
56,2020-03-16,74,0,7055,299,14971,251297,8236,75,1106,274504,259533,3.173392208
57,2020-03-17,84,6,6877,256,17291,261105,8320,81,1362,286716,269425,3.088057901
58,2020-03-18,93,3,6831,136,16346,270888,8413,84,1498,295647,279301,3.012162506
59,2020-03-19,152,7,6578,398,15904,282555,8565,91,1896,307024,291120,2.942085738
60,2020-03-20,87,3,6385,277,15525,292487,8652,94,2173,316664,301139,2.873091828
61,2020-03-21,147,8,6161,363,15704,303006,8799,102,2536,327509,311805,2.82195603
62,2020-03-22,98,2,5976,281,14540,308343,8897,104,2817,331780,317240,2.804501324
63,2020-03-23,64,7,5785,248,13628,315447,8961,111,3065,338036,324408,2.762262336
64,2020-03-24,76,9,5521,331,15440,324105,9037,120,3396,348582,333142,2.712657065
65,2020-03-25,100,6,5405,210,14278,334481,9137,126,3606,357896,343618,2.659057442
66,2020-03-26,104,5,5109,395,14369,341332,9241,131,4001,364942,350573,2.635970254
67,2020-03-27,91,8,4826,366,15219,352410,9332,139,4367,376961,361742,2.579739151
68,2020-03-28,146,5,4693,274,16564,361883,9478,144,4641,387925,371361,2.552233541
69,2020-03-29,105,8,4574,216,15028,369530,9583,152,4857,394141,379113,2.527742388
70,2020-03-30,78,6,4460,186,13531,375710,9661,158,5043,398902,385371,2.506934876
71,2020-03-31,125,4,4418,163,16892,383886,9786,162,5206,410564,393672,2.485825764
72,2020-04-01,101,3,4361,155,16585,395075,9887,165,5361,421547,404962,2.441463644
73,2020-04-02,89,4,4198,248,17885,403882,9976,169,5609,431743,413858,2.410488622
74,2020-04-03,86,5,4099,180,18908,414303,10062,174,5789,443273,424365,2.371072072
75,2020-04-04,94,3,3895,295,20144,424732,10156,177,6084,455032,434888,2.33531392
76,2020-04-05,81,6,3827,143,19571,431425,10237,183,6227,461233,441662,2.317835811
77,2020-04-06,47,3,3739,132,19295,437225,10284,186,6359,466804,447509,2.298054341
78,2020-04-07,47,6,3688,92,20650,446323,10331,192,6451,477304,456654,2.262325524
79,2020-04-08,53,8,3654,79,17858,457761,10384,200,6530,486003,468145,2.218116182
80,2020-04-09,39,4,3504,185,15509,468779,10423,204,6715,494711,479202,2.175074395
81,2020-04-10,27,4,3371,156,15298,477303,10450,208,6871,503051,487753,2.142477853
82,2020-04-11,30,3,3275,123,14070,485929,10480,211,6994,510479,496409,2.111162368
83,2020-04-12,32,3,3176,128,13788,490321,10512,214,7122,514621,500833,2.098903227
84,2020-04-13,25,3,3122,76,13391,494815,10537,217,7198,518743,505352,2.08508129
85,2020-04-14,27,5,3051,93,14651,502223,10564,222,7291,527438,512787,2.060114628
86,2020-04-15,27,3,2989,86,15026,508935,10591,225,7377,534552,519526,2.038589022
87,2020-04-16,22,4,2868,139,14268,513894,10613,229,7516,538775,524507,2.023423901
88,2020-04-17,22,1,2807,82,14186,521642,10635,230,7598,546463,532277,1.998019828
89,2020-04-18,18,2,2715,108,13550,530631,10653,232,7706,554834,541284,1.968098078
90,2020-04-19,8,2,2620,101,12243,536205,10661,234,7807,559109,546866,1.949472083
91,2020-04-20,13,2,2565,66,11981,540380,10674,236,7873,563035,551054,1.937015247
92,2020-04-21,9,1,2470,103,12721,547610,10683,237,7976,571014,558293,1.913511364
93,2020-04-22,11,1,2409,71,12121,555144,10694,238,8047,577959,565838,1.88994023
94,2020-04-23,8,2,2270,145,10139,563130,10702,240,8192,583971,573832,1.865005786
95,2020-04-24,6,0,2184,92,9600,569212,10708,240,8284,589520,579920,1.846461581
96,2020-04-25,10,0,2042,152,9259,575184,10718,240,8436,595161,585902,1.829316166
97,2020-04-26,10,2,1961,89,8999,578558,10728,242,8525,598285,589286,1.820508208
98,2020-04-27,10,1,1922,48,8895,582027,10738,243,8573,601660,592765,1.811510464
99,2020-04-28,14,1,1835,100,9203,588559,10752,244,8673,608514,599311,1.794060179
100,2020-04-29,9,2,1779,63,8307,595129,10761,246,8736,614197,605890,1.776064962
101,2020-04-30,4,1,1642,140,8634,600482,10765,247,8876,619881,611247,1.761153838
102,2020-05-01,9,1,1616,34,8685,603610,10774,248,8910,623069,614384,1.753626397
103,2020-05-02,6,2,1562,58,8496,608286,10780,250,8968,627562,619066,1.741332911
104,2020-05-03,13,0,1511,64,8588,611592,10793,250,9032,630973,622385,1.734135623
105,2020-05-04,8,2,1476,41,8176,614944,10801,252,9073,633921,625745,1.726102486
106,2020-05-05,3,2,1406,71,8858,620575,10804,254,9144,640237,631379,1.711175063
107,2020-05-06,2,1,1356,51,8009,624280,10806,255,9195,643095,635086,1.701501844
108,2020-05-07,4,1,1268,91,8429,630149,10810,256,9286,649388,640959,1.686535332
109,2020-05-08,12,0,1210,70,8867,635174,10822,256,9356,654863,645996,1.675242571
110,2020-05-09,18,0,1140,88,9153,640037,10840,256,9444,660030,650877,1.665445238
111,2020-05-10,34,0,1125,49,10128,642884,10874,256,9493,663886,653758,1.663306606
112,2020-05-11,35,0,1126,34,10922,646661,10909,256,9527,668492,657570,1.658986876
113,2020-05-12,27,2,1111,40,16330,653624,10936,258,9567,680890,664560,1.645600096
114,2020-05-13,26,1,1074,62,19579,665379,10962,259,9629,695920,676341,1.62078005
115,2020-05-15,56,1,984,145,19875,695854,11018,260,9774,726747,706872,1.558698039
116,2020-05-16,19,2,964,37,18343,711265,11037,262,9811,740645,722302,1.528031211
117,2020-05-17,13,0,928,49,17660,718943,11050,262,9860,747653,729993,1.513713145
118,2020-05-18,15,1,919,23,16093,726053,11065,263,9883,753211,737118,1.501116511
119,2020-05-19,13,0,885,47,16925,737571,11078,263,9930,765574,748649,1.479732158
120,2020-05-20,32,0,786,131,16351,748972,11110,263,10061,776433,760082,1.461684397
121,2020-05-21,12,1,726,71,18089,759473,11122,264,10132,788684,770595,1.443300307
122,2020-05-22,20,0,719,27,20286,770990,11142,264,10159,802418,782132,1.42456772
123,2020-05-23,23,2,707,33,21569,781686,11165,266,10192,814420,792851,1.408209109
124,2020-05-24,25,0,713,19,20333,788766,11190,266,10211,820289,799956,1.398826935
125,2020-05-25,16,1,715,13,19089,796142,11206,267,10224,826437,807348,1.388001209
126,2020-05-26,19,2,683,49,22044,806206,11225,269,10273,839475,817431,1.373204589
127,2020-05-27,40,0,702,21,21061,820550,11265,269,10294,852876,831815,1.354267475
128,2020-05-28,79,0,736,45,22370,834952,11344,269,10339,868666,846296,1.340429353
129,2020-05-29,58,0,771,23,24557,849161,11402,269,10362,885120,860563,1.324946576
130,2020-05-30,39,0,775,35,26298,865162,11441,269,10397,902901,876603,1.305151819
131,2020-05-31,27,1,794,7,23294,876060,11468,270,10404,910822,887528,1.292128248
132,2020-06-01,35,1,811,17,24058,885830,11503,271,10421,921391,897333,1.281909837
133,2020-06-02,38,1,824,24,28922,899388,11541,272,10445,939851,910929,1.266948357
134,2020-06-03,49,1,851,21,27865,917397,11590,273,10466,956852,928987,1.247595499
135,2020-06-04,39,0,858,32,28199,934030,11629,273,10498,973858,945659,1.229724457
136,2020-06-05,39,0,890,7,28766,950526,11668,273,10505,990960,962194,1.212645267
137,2020-06-06,51,0,915,26,27954,965632,11719,273,10531,1005305,977351,1.199057452
138,2020-06-07,57,0,951,21,26481,974512,11776,273,10552,1012769,986288,1.193971741
139,2020-06-08,37,0,977,11,24374,982027,11813,273,10563,1018214,993840,1.188621911
140,2020-06-09,38,1,987,27,27459,996687,11851,274,10590,1035997,1008538,1.175067276
141,2020-06-10,50,2,1014,21,26223,1013848,11901,276,10611,1051972,1025749,1.160225357
142,2020-06-11,45,0,1017,42,25494,1029448,11946,276,10653,1066888,1041394,1.147116269
143,2020-06-12,56,1,1057,15,24244,1045240,12002,277,10668,1081486,1057242,1.135217859
144,2020-06-13,48,0,1082,23,23352,1059302,12050,277,10691,1094704,1071352,1.124747049
145,2020-06-14,34,0,1089,27,21356,1066887,12084,277,10718,1100327,1078971,1.119955958
146,2020-06-15,37,0,1114,12,20793,1072805,12121,277,10730,1105719,1084926,1.117219055
147,2020-06-16,34,1,1117,30,22632,1084980,12155,278,10760,1119767,1097135,1.107885538
148,2020-06-17,43,1,1145,14,21489,1099136,12198,279,10774,1132823,1111334,1.097599821
149,2020-06-18,59,1,1177,26,21714,1111741,12257,280,10800,1145712,1123998,1.090482367
150,2020-06-19,49,0,1191,35,21190,1124567,12306,280,10835,1158063,1136873,1.082442806
151,2020-06-20,67,0,1233,25,21470,1137058,12373,280,10860,1170901,1149431,1.07644565
152,2020-06-21,48,0,1274,7,20071,1143971,12421,280,10867,1176463,1156392,1.074116736
153,2020-06-22,17,0,1278,13,19403,1150225,12438,280,10880,1182066,1162663,1.069785484
154,2020-06-23,46,1,1296,27,22278,1161250,12484,281,10907,1196012,1173734,1.063614073
155,2020-06-24,51,0,1325,22,20245,1175817,12535,281,10929,1208597,1188352,1.05482214
156,2020-06-25,28,1,1308,44,18900,1189015,12563,282,10973,1220478,1201578,1.045541779
157,2020-06-26,39,0,1149,198,18828,1200885,12602,282,11171,1232315,1213487,1.03849485
158,2020-06-27,51,0,1057,143,19866,1211261,12653,282,11314,1243780,1223914,1.033814467
159,2020-06-28,62,0,1073,46,19005,1219975,12715,282,11360,1251695,1232690,1.03148399
160,2020-06-29,42,0,1050,65,18499,1228698,12757,282,11425,1259954,1241455,1.027584568
161,2020-06-30,42,0,984,108,20809,1240157,12799,282,11533,1273765,1252956,1.021504347
162,2020-07-01,51,0,957,78,19526,1252855,12850,282,11611,1285231,1265705,1.015244468
163,2020-07-02,54,0,941,70,19782,1263276,12904,282,11681,1295962,1276180,1.011142629
164,2020-07-03,61,0,928,74,21560,1273234,12965,282,11755,1307759,1286199,1.00800887
165,2020-07-04,63,1,937,53,22321,1284172,13028,283,11808,1319521,1297200,1.00431699
166,2020-07-05,61,0,978,20,21649,1291317,13089,283,11828,1326055,1304406,1.003445246
167,2020-07-06,48,1,1008,17,21292,1297367,13137,284,11845,1331796,1310504,1.002438756
168,2020-07-07,44,1,985,66,23675,1309338,13181,285,11911,1346194,1322519,0.996658649
169,2020-07-08,62,0,991,56,24012,1322479,13243,285,11967,1359734,1335722,0.991448819
170,2020-07-09,50,2,990,49,23912,1334566,13293,287,12016,1371771,1347859,0.986230756
171,2020-07-10,45,1,989,45,23527,1348025,13338,288,12061,1384890,1361363,0.97975338
172,2020-07-11,35,0,946,78,22950,1360618,13373,288,12139,1396941,1373991,0.973296041
173,2020-07-12,44,1,955,34,21830,1366897,13417,289,12173,1402144,1380314,0.972025206
174,2020-07-13,62,0,992,25,21845,1372988,13479,289,12198,1408312,1386467,0.972183254
175,2020-07-14,33,0,948,77,24289,1382815,13512,289,12275,1420616,1396327,0.967681639
176,2020-07-15,39,0,918,69,23297,1394468,13551,289,12344,1431316,1408019,0.96241599
177,2020-07-16,61,2,928,49,23404,1404332,13612,291,12393,1441348,1417944,0.959981494
178,2020-07-17,60,2,924,62,23110,1414235,13672,293,12455,1451017,1427907,0.957485326
179,2020-07-18,39,1,904,58,22923,1423570,13711,294,12513,1460204,1437281,0.953954028
180,2020-07-19,34,1,901,36,21953,1429601,13745,295,12549,1465299,1443346,0.952301111
181,2020-07-20,26,1,908,18,21302,1435120,13771,296,12567,1470193,1448891,0.950451069
182,2020-07-21,45,0,882,71,23864,1444710,13816,296,12638,1482390,1458526,0.947257711
183,2020-07-22,63,1,890,54,21751,1456441,13879,297,12692,1492071,1470320,0.943944175
184,2020-07-23,59,0,889,60,21418,1465498,13938,297,12752,1500854,1479436,0.942115779
185,2020-07-24,41,1,870,59,20559,1475789,13979,298,12811,1510327,1489768,0.938334022
186,2020-07-25,113,0,934,49,19681,1484861,14092,298,12860,1518634,1498953,0.940122872
187,2020-07-26,58,0,968,24,19214,1489562,14150,298,12884,1522926,1503712,0.94100466
188,2020-07-27,25,1,977,15,18770,1494029,14175,299,12899,1526974,1508204,0.939859595
189,2020-07-28,28,1,901,103,20444,1503057,14203,300,13002,1537704,1517260,0.93609533
190,2020-07-29,48,0,885,64,19326,1513730,14251,300,13066,1547307,1527981,0.932668665
191,2020-07-30,18,0,841,62,19018,1522928,14269,300,13128,1556215,1537197,0.928247973
192,2020-07-31,36,1,825,51,18330,1531161,14305,301,13179,1563796,1545466,0.925610787
193,2020-08-01,31,0,807,49,18278,1539216,14336,301,13228,1571830,1553552,0.922788552
194,2020-08-02,30,0,811,26,17768,1544112,14366,301,13254,1576246,1558478,0.921796779
195,2020-08-03,23,0,813,21,17401,1547967,14389,301,13275,1579757,1562356,0.920980878
196,2020-08-04,34,0,776,71,18724,1556633,14423,301,13346,1589780,1571056,0.918044933
197,2020-08-05,33,1,752,56,18490,1565241,14456,302,13402,1598187,1579697,0.915112202
198,2020-08-06,43,0,701,94,18031,1573957,14499,302,13496,1606487,1588456,0.912773158
199,2020-08-07,20,1,676,44,17068,1582065,14519,303,13540,1613652,1596584,0.909379024
200,2020-08-08,43,1,633,85,16105,1589847,14562,304,13625,1620514,1604409,0.907623929
201,2020-08-09,36,1,655,13,16803,1593249,14598,305,13638,1624650,1607847,0.907922209
202,2020-08-10,28,0,667,16,16396,1597281,14626,305,13654,1628303,1611907,0.907372448
203,2020-08-11,34,0,630,71,17489,1605695,14660,305,13725,1637844,1620355,0.904740011
204,2020-08-12,54,0,626,58,17375,1614563,14714,305,13783,1646652,1629277,0.903099964
205,2020-08-13,56,0,651,31,17798,1622330,14770,305,13814,1654898,1637100,0.902205119
206,2020-08-14,103,0,707,47,20132,1630079,14873,305,13861,1665084,1644952,0.904160121
207,2020-08-15,166,0,835,38,21618,1638639,15039,305,13899,1675296,1653678,0.909427349
208,2020-08-16,279,0,1105,9,22005,1644464,15318,305,13908,1681787,1659782,0.922892283
209,2020-08-17,197,0,1295,7,22964,1649991,15515,305,13915,1688470,1665506,0.931548731
210,2020-08-18,246,1,1523,17,25219,1656062,15761,306,13932,1697042,1671823,0.942743341
211,2020-08-19,297,0,1748,72,31022,1667984,16058,306,14004,1715064,1684042,0.953539164
212,2020-08-20,288,1,1978,57,34998,1682739,16346,307,14061,1734083,1699085,0.96204722
213,2020-08-21,324,2,2243,57,38045,1699408,16670,309,14118,1754123,1716078,0.971401067
214,2020-08-22,332,0,2527,48,42427,1716371,17002,309,14166,1775800,1733373,0.980862169
215,2020-08-23,396,0,2892,31,47564,1726224,17398,309,14197,1791186,1743622,0.997808011
216,2020-08-24,266,0,3139,19,47995,1738763,17664,309,14216,1804422,1756427,1.005678004
217,2020-08-25,280,1,3351,67,50362,1757531,17944,310,14283,1825837,1775475,1.010659119
218,2020-08-26,320,2,3588,81,52795,1778447,18264,312,14364,1849506,1796711,1.016524082
219,2020-08-27,441,1,3935,93,52041,1798833,18705,313,14457,1869579,1817538,1.029139418
220,2020-08-28,371,3,4213,90,50711,1817930,19076,316,14547,1887717,1837006,1.038428835
221,2020-08-29,323,5,4318,213,54046,1835884,19399,321,14760,1909329,1855283,1.045608675
222,2020-08-30,299,2,4477,138,58021,1846451,19698,323,14898,1924170,1866149,1.055542725
223,2020-08-31,248,1,4656,68,57876,1859867,19946,324,14966,1937689,1879813,1.061062989
224,2020-09-01,235,0,4665,226,56743,1882156,20181,324,15192,1959080,1902337,1.060853045
225,2020-09-02,267,2,4771,159,56748,1903099,20448,326,15351,1980295,1923547,1.063036151
226,2020-09-03,195,3,4792,171,55524,1924385,20643,329,15522,2000552,1945028,1.061321482
227,2020-09-04,198,2,4746,242,52266,1945799,20841,331,15764,2018906,1966640,1.059726234
228,2020-09-05,168,2,4693,219,52077,1963959,21009,333,15983,2037045,1984968,1.058404972
229,2020-09-06,167,1,4724,135,49621,1975138,21176,334,16118,2045935,1996314,1.060754971
230,2020-09-07,119,2,4671,170,47109,1982893,21295,336,16288,2051297,2004188,1.062525072
231,2020-09-08,136,5,4459,343,43370,2001277,21431,341,16631,2066078,2022708,1.059520208
232,2020-09-09,156,3,4227,385,36533,2024114,21587,344,17016,2082234,2045701,1.0552373
233,2020-09-10,155,2,4043,337,33018,2044831,21742,346,17353,2099591,2066573,1.052079941
234,2020-09-11,176,4,3959,256,29423,2067870,21918,350,17609,2119211,2089788,1.048814521
235,2020-09-12,136,5,3677,413,27826,2085577,22054,355,18022,2135457,2107631,1.046388101
236,2020-09-13,121,3,3596,199,27705,2093390,22175,358,18221,2143270,2115565,1.048183346
237,2020-09-14,109,5,3439,261,27476,2101242,22284,363,18482,2151002,2123526,1.049386728
238,2020-09-15,106,4,3153,388,27310,2114878,22390,367,18870,2164578,2137268,1.047599084
239,2020-09-16,113,0,2838,428,25842,2130487,22503,367,19298,2178832,2152990,1.045197609
240,2020-09-17,153,5,2751,235,25508,2143728,22656,372,19533,2191892,2166384,1.045797975
241,2020-09-18,126,5,2644,228,25403,2158180,22782,377,19761,2206365,2180962,1.044584913
242,2020-09-19,110,1,2552,201,24705,2171565,22892,378,19962,2219162,2194457,1.043173778
243,2020-09-20,82,5,2441,188,24274,2179453,22974,383,20150,2226701,2202427,1.043121974
244,2020-09-21,70,2,2420,89,22536,2186009,23044,385,20239,2231589,2209053,1.043161934
245,2020-09-22,61,3,2283,195,23222,2198785,23105,388,20434,2245112,2221890,1.039880462
246,2020-09-23,110,0,2184,209,20527,2213157,23215,388,20643,2256899,2236372,1.038065223
247,2020-09-24,125,5,2123,181,20782,2224877,23340,393,20824,2268999,2248217,1.038156014
248,2020-09-25,114,2,2088,147,19575,2237247,23454,395,20971,2280276,2260701,1.037465813
249,2020-09-26,61,4,1958,187,18508,2248322,23515,399,21158,2290345,2271837,1.035065456
250,2020-09-27,95,2,1969,82,18878,2254029,23610,401,21240,2296517,2277639,1.036599742
251,2020-09-28,50,5,1970,44,18587,2259056,23660,406,21284,2301303,2282716,1.036484609
252,2020-09-29,38,1,1829,178,20056,2269290,23698,407,21462,2313044,2292988,1.033498649
253,2020-09-30,113,6,1812,124,20596,2278592,23811,413,21586,2322999,2302403,1.034180376
254,2020-10-01,77,2,1815,72,20029,2284518,23888,415,21658,2328435,2308406,1.034826629
255,2020-10-02,63,1,1810,67,19995,2289831,23951,416,21725,2333777,2313782,1.035145057
256,2020-10-03,75,4,1827,54,21287,2294546,24026,420,21779,2339859,2318572,1.036241273
257,2020-10-04,64,1,1832,58,22116,2300139,24090,421,21837,2346345,2324229,1.03647274
258,2020-10-05,73,1,1863,41,22447,2305768,24163,422,21878,2352378,2329931,1.037069338
259,2020-10-06,75,0,1743,195,22737,2318458,24238,422,22073,2365433,2342696,1.034619942
260,2020-10-07,114,3,1601,253,22138,2331583,24352,425,22326,2378073,2355935,1.033644816
261,2020-10-08,69,2,1537,131,20978,2343445,24421,427,22457,2388844,2367866,1.031350592
262,2020-10-09,54,1,1485,105,20699,2355059,24475,428,22562,2400233,2379534,1.028562735
263,2020-10-10,72,2,1500,55,18982,2361155,24547,430,22617,2404684,2385702,1.028921466
264,2020-10-11,58,2,1487,69,19303,2366575,24605,432,22686,2410483,2391180,1.028989871
265,2020-10-12,98,1,1548,36,19192,2371715,24703,433,22722,2415610,2396418,1.030830181
266,2020-10-13,91,1,1504,134,20124,2383842,24794,434,22856,2428760,2408636,1.029379284
267,2020-10-14,84,4,1417,167,18396,2398169,24878,438,23023,2441443,2423047,1.02672379
268,2020-10-15,110,1,1474,52,18262,2407489,24988,439,23075,2450739,2432477,1.027265623
269,2020-10-16,47,2,1421,98,17355,2417036,25035,441,23173,2459426,2442071,1.025154469
270,2020-10-17,73,2,1413,79,17318,2426101,25108,443,23252,2468527,2451209,1.02431086
271,2020-10-18,91,1,1450,53,17781,2431549,25199,444,23305,2474529,2456748,1.025705526
272,2020-10-19,76,0,1471,55,16763,2437188,25275,444,23360,2479226,2462463,1.026411361
273,2020-10-20,58,3,1428,98,19379,2446599,25333,447,23458,2491311,2471932,1.024825926
274,2020-10-21,89,3,1396,118,19493,2458574,25422,450,23576,2503489,2483996,1.0234316
275,2020-10-22,121,3,1449,65,19813,2469969,25543,453,23641,2515325,2495512,1.02355749
276,2020-10-23,155,2,1532,70,20430,2482493,25698,455,23711,2528621,2508191,1.024563121
277,2020-10-24,77,2,1490,117,21888,2493016,25775,457,23828,2540679,2518791,1.023308405
278,2020-10-25,61,0,1516,35,21682,2498628,25836,457,23863,2546146,2524464,1.023425171
279,2020-10-26,119,0,1603,32,20763,2505546,25955,457,23895,2552264,2531501,1.025281049
280,2020-10-27,88,3,1608,80,23003,2518541,26043,460,23975,2567587,2544584,1.023467883
281,2020-10-28,103,1,1617,93,22904,2533910,26146,461,24068,2582960,2560056,1.021305784
282,2020-10-29,125,1,1646,95,26148,2545559,26271,462,24163,2597978,2571830,1.021490534
283,2020-10-30,113,1,1698,60,26373,2559474,26384,463,24223,2612231,2585858,1.020318981
284,2020-10-31,127,1,1740,84,25678,2572303,26511,464,24307,2624492,2598814,1.020119177
285,2020-11-01,124,2,1816,46,24838,2579157,26635,466,24353,2630630,2605792,1.02214605
286,2020-11-02,97,2,1873,38,25524,2584394,26732,468,24391,2636650,2611126,1.023772886
287,2020-11-03,75,4,1830,114,25815,2597237,26807,472,24505,2649859,2624044,1.021591101
288,2020-11-04,117,2,1837,108,24255,2611080,26924,474,24613,2662259,2638004,1.020620136
289,2020-11-05,125,1,1842,119,25062,2621594,27049,475,24732,2673705,2648643,1.021239933
290,2020-11-06,145,1,1900,86,25629,2633490,27194,476,24818,2686313,2660684,1.02206801
291,2020-11-07,89,1,1898,90,26217,2643748,27283,477,24908,2697248,2671031,1.021440784
292,2020-11-08,143,1,1983,57,25648,2649805,27426,478,24965,2702879,2677231,1.024416645
293,2020-11-09,126,2,2047,60,25802,2655844,27552,480,25025,2709198,2683396,1.02675863
294,2020-11-10,100,5,2012,130,27855,2668452,27652,485,25155,2723959,2696104,1.025628091
295,2020-11-11,145,2,2049,106,28688,2680047,27797,487,25261,2736532,2707844,1.026536241
296,2020-11-12,143,0,2053,139,29284,2692546,27940,487,25400,2749770,2720486,1.027022378
297,2020-11-13,191,1,2111,132,30119,2703159,28131,488,25532,2761409,2731290,1.029952879
298,2020-11-14,205,4,2211,101,34692,2714259,28336,492,25633,2777287,2742595,1.033182078
299,2020-11-15,208,1,2363,55,36378,2721954,28544,493,25688,2786876,2750498,1.037775705
300,2020-11-16,222,1,2517,67,38314,2730609,28766,494,25755,2797689,2759375,1.042482446
301,2020-11-17,230,0,2646,101,41202,2745555,28996,494,25856,2815753,2774551,1.045069995
302,2020-11-18,285,2,2816,113,42688,2762363,29281,496,25969,2834332,2791644,1.048880158
303,2020-11-19,325,2,3014,125,45525,2778664,29606,498,26094,2853795,2808270,1.05424336
304,2020-11-20,348,3,3193,166,48143,2795283,29954,501,26260,2873380,2825237,1.060229637
305,2020-11-21,386,2,3476,101,51345,2814998,30340,503,26361,2896683,2845338,1.066305655
306,2020-11-22,330,2,3704,100,54029,2824128,30670,505,26461,2908827,2854798,1.074331704
307,2020-11-23,271,4,3900,71,56455,2834676,30941,509,26532,2922072,2865617,1.079732567
308,2020-11-24,349,1,4064,184,57769,2857277,31290,510,26716,2946336,2888567,1.083236082
309,2020-11-25,382,3,4340,103,55838,2878832,31672,513,26819,2966342,2910504,1.088196409
310,2020-11-26,581,2,4794,125,55361,2900368,32253,515,26944,2987982,2932621,1.099801168
311,2020-11-27,555,1,5195,153,56637,2920054,32808,516,27097,3009499,2952862,1.111057679
312,2020-11-28,503,6,5461,231,58794,2939835,33311,522,27328,3031940,2973146,1.120395702
313,2020-11-29,450,1,5732,178,62829,2950318,33761,523,27506,3046908,2984079,1.131370852
314,2020-11-30,438,3,6061,106,63365,2963606,34199,526,27612,3061170,2997805,1.140801353
315,2020-12-01,451,0,6249,263,64892,2984453,34650,526,27875,3083995,3019103,1.147691881
316,2020-12-02,511,0,6582,178,65154,3006653,35161,526,28053,3106968,3041814,1.155922091
317,2020-12-03,540,3,6831,288,65788,3030395,35701,529,28341,3131884,3066096,1.164379719
318,2020-12-04,628,7,7194,258,64017,3057061,36329,536,28599,3157407,3093390,1.174407365
319,2020-12-05,577,4,7459,308,66267,3077314,36906,540,28907,3180487,3114220,1.185080052
320,2020-12-06,631,5,7872,213,67716,3089605,37537,545,29120,3194858,3127142,1.200361224
321,2020-12-07,615,4,8310,173,68010,3103205,38152,549,29293,3209367,3141357,1.214506979
322,2020-12-08,587,3,8547,347,75080,3107497,38739,552,29640,3221316,3146236,1.231280807
323,2020-12-09,670,4,8686,527,71274,3142536,39409,556,30167,3253219,3181945,1.238519208
324,2020-12-10,680,8,8899,459,72764,3165093,40089,564,30626,3277946,3205182,1.250755807
325,2020-12-11,689,8,9059,521,77688,3192745,40778,572,31147,3311211,3233523,1.261101282
326,2020-12-12,950,6,9668,335,86742,3221392,41728,578,31482,3349862,3263120,1.278776141
327,2020-12-13,1030,2,10375,321,90127,3241708,42758,580,31803,3374593,3284466,1.301825015
328,2020-12-14,718,7,10797,289,89247,3264314,43476,587,32092,3397037,3307790,1.314351878
329,2020-12-15,880,13,11208,456,93473,3303389,44356,600,32548,3441218,3347745,1.324951572
330,2020-12-16,1078,12,11888,386,94784,3348549,45434,612,32934,3488767,3393983,1.338663158
331,2020-12-17,1014,22,12219,661,99258,3393132,46448,634,33595,3538838,3439580,1.350397432
332,2020-12-18,1064,11,12901,371,110618,3431665,47512,645,33966,3589795,3479177,1.365610315
333,2020-12-19,1045,14,13576,356,126233,3471455,48557,659,34322,3646245,3520012,1.379455525
334,2020-12-20,1096,15,14270,387,139475,3493963,49653,674,34709,3683091,3543616,1.401195841
335,2020-12-21,924,24,14740,430,146438,3516841,50577,698,35139,3713856,3567418,1.417748074
336,2020-12-22,866,24,14809,773,151129,3569853,51443,722,35912,3772425,3621296,1.420568769
337,2020-12-23,1090,17,15084,798,153109,3620923,52533,739,36710,3826565,3673456,1.430070212
338,2020-12-24,985,17,15362,690,150533,3678154,53518,756,37400,3882205,3731672,1.434156057
339,2020-12-25,1240,17,15957,628,156789,3727805,54758,773,38028,3939352,3782563,1.447642776
340,2020-12-26,1131,20,16582,486,157012,3756508,55889,793,38514,3969409,3812397,1.465980589
341,2020-12-27,970,15,17031,506,166976,3782571,56859,808,39020,4006406,3839430,1.48092295
342,2020-12-28,806,11,17597,229,169878,3810757,57665,819,39249,4038300,3868422,1.490659499
343,2020-12-29,1044,40,17165,1436,170962,3868502,58709,859,40685,4098173,3927211,1.494928589
344,2020-12-30,1050,20,17469,726,171771,3927986,59759,879,41411,4159516,3987745,1.498566232
345,2020-12-31,967,21,17594,821,170338,3982810,60726,900,42232,4213874,4043536,1.501804361
346,2021-01-01,1027,17,17907,697,176927,4030632,61753,917,42929,4269312,4092385,1.508973374
347,2021-01-02,820,25,18085,617,179387,4060832,62573,942,43546,4302792,4123405,1.517507982
348,2021-01-03,657,20,17791,931,186472,4091130,63230,962,44477,4340832,4154360,1.522015425
349,2021-01-04,1020,19,18061,731,190732,4121620,64250,981,45208,4376602,4185870,1.534925834
350,2021-01-05,714,26,17820,929,193751,4180639,64964,1007,46137,4439354,4245603,1.530147779
351,2021-01-06,838,20,17810,828,192082,4246976,65802,1027,46965,4504860,4312778,1.525745123
352,2021-01-07,869,19,18003,657,191762,4311369,66671,1046,47622,4569802,4378040,1.522850408
353,2021-01-08,674,35,17935,707,190452,4372201,67345,1081,48329,4629998,4439546,1.516934389
354,2021-01-09,641,19,17603,954,185923,4435701,67986,1100,49283,4689610,4503687,1.509563165
355,2021-01-10,657,25,17131,1104,191454,4463360,68643,1125,50387,4723457,4532003,1.5146283
356,2021-01-11,451,15,15431,2136,189763,4492822,69094,1140,52523,4751679,4561916,1.514582908
357,2021-01-12,537,25,14929,1014,186770,4557678,69631,1165,53537,4814079,4627309,1.504783882
358,2021-01-13,561,20,14400,1070,182914,4619200,70192,1185,54607,4872306,4689392,1.496825175
359,2021-01-14,524,10,13849,1065,169742,4684895,70716,1195,55672,4925353,4755611,1.487001355
360,2021-01-15,512,22,13518,821,162323,4744517,71228,1217,56493,4978068,4815745,1.479065025
361,2021-01-16,580,19,13060,1019,155639,4804817,71808,1236,57512,5032264,4876625,1.472493784
362,2021-01-17,520,13,12874,693,159385,4829571,72328,1249,58205,5061284,4901899,1.475509797
363,2021-01-18,389,15,12776,472,158035,4856462,72717,1264,58677,5087214,4929179,1.475235531
364,2021-01-19,386,19,12386,757,154345,4912872,73103,1283,59434,5140320,4985975,1.466172614
365,2021-01-20,404,17,12063,710,148141,4970476,73507,1300,60144,5192124,5043983,1.457320534
366,2021-01-21,400,16,11775,672,141070,5022625,73907,1316,60816,5237602,5096532,1.45014296
367,2021-01-22,346,12,11541,568,133132,5074835,74253,1328,61384,5282220,5149088,1.442061196
368,2021-01-23,431,9,11331,632,136629,5118391,74684,1337,62016,5329704,5193075,1.438145992
369,2021-01-24,392,12,11224,487,135765,5143505,75076,1349,62503,5354346,5218581,1.438628623
370,2021-01-25,437,11,11223,427,134549,5166021,75513,1360,62930,5376083,5241534,1.440666034
371,2021-01-26,349,11,9723,1838,138624,5208274,75862,1371,64768,5422760,5284136,1.435655706
372,2021-01-27,559,7,9587,688,138427,5254396,76421,1378,65456,5469244,5330817,1.433570126
373,2021-01-28,497,8,9536,540,139424,5305844,76918,1386,65996,5522186,5382762,1.428968994
374,2021-01-29,469,13,9508,484,142753,5349121,77387,1399,66480,5569261,5426508,1.426092065
375,2021-01-30,456,15,9332,617,145795,5392889,77843,1414,67097,5616527,5470732,1.422899166
376,2021-01-31,354,6,8940,740,149550,5413070,78197,1420,67837,5640817,5491267,1.424024729
377,2021-02-01,305,5,8790,450,149456,5433883,78502,1425,68287,5661841,5512385,1.424102272
378,2021-02-02,336,10,8647,469,154265,5478309,78838,1435,68756,5711412,5557147,1.418677606
379,2021-02-03,467,6,8584,524,138849,5538559,79305,1441,69280,5756713,5617864,1.411657527
380,2021-02-04,451,7,8621,407,120538,5602800,79756,1448,69687,5803094,5682556,1.403523344
381,2021-02-05,370,11,8579,401,107457,5659594,80126,1459,70088,5847177,5739720,1.395991442
382,2021-02-06,390,5,8562,402,97677,5715159,80516,1464,70490,5893352,5795675,1.389242841
383,2021-02-07,371,7,8576,350,90751,5745336,80887,1471,70840,5916974,5826223,1.388326537
384,2021-02-08,288,3,8497,364,84843,5772177,81175,1474,71204,5938195,5853352,1.386812206
385,2021-02-09,303,8,8335,457,82630,5823296,81478,1482,71661,5987404,5904774,1.379866528
386,2021-02-10,444,4,8226,549,80076,5868024,81922,1486,72210,6030022,5949946,1.376852832
387,2021-02-11,504,10,8303,417,81614,5905967,82426,1496,72627,6070007,5988393,1.376429369
388,2021-02-12,403,11,8395,300,80861,5929678,82829,1507,72927,6093368,6012507,1.377611702
389,2021-02-13,362,7,8458,292,70251,5961894,83191,1514,73219,6115336,6045085,1.376175852
390,2021-02-14,326,8,8444,332,78200,5978368,83517,1522,73551,6140085,6061885,1.377739762
391,2021-02-15,343,5,8547,235,80146,5998853,83860,1527,73786,6162859,6082713,1.378661134
392,2021-02-16,457,7,8242,755,76897,6052275,84317,1534,74541,6213489,6136592,1.374003682
393,2021-02-17,621,4,8050,809,72410,6103218,84938,1538,75350,6260566,6188156,1.372589831
394,2021-02-18,621,6,8128,537,70720,6146934,85559,1544,75887,6303213,6232493,1.372789348
395,2021-02-19,561,6,8067,616,71116,6188755,86120,1550,76503,6345991,6274875,1.372457619
396,2021-02-20,448,3,7944,568,76137,6227925,86568,1553,77071,6390630,6314493,1.37094142
397,2021-02-21,416,4,7925,431,73356,6250999,86984,1557,77502,6411339,6337983,1.372424003
398,2021-02-22,332,5,7882,370,72461,6269366,87316,1562,77872,6429143,6356682,1.373609691
399,2021-02-23,356,11,7720,507,74065,6310941,87672,1573,78379,6472678,6398613,1.370171942
400,2021-02-24,440,3,7501,656,74988,6347887,88112,1576,79035,6510987,6435999,1.369049312
401,2021-02-25,395,5,7453,438,68672,6394034,88507,1581,79473,6551213,6482541,1.365313386
402,2021-02-26,387,4,7444,392,68942,6432229,88894,1585,79865,6590065,6521123,1.363170117
403,2021-02-27,415,10,7396,453,68989,6468916,89309,1595,80318,6627214,6558225,1.361786154
404,2021-02-28,355,8,7378,365,72889,6486452,89664,1603,80683,6649005,6576116,1.363479598
405,2021-03-01,355,2,7358,373,73745,6501990,90019,1605,81056,6665754,6592009,1.365577626
406,2021-03-02,344,1,7433,268,73432,6518180,90363,1606,81324,6681975,6608543,1.367366453
407,2021-03-03,444,6,7508,363,65867,6559528,90807,1612,81687,6716202,6650335,1.365450011
408,2021-03-04,424,7,7464,461,60089,6600579,91231,1619,82148,6751899,6691810,1.363323226
409,2021-03-05,398,8,7457,397,63707,6633674,91629,1627,82545,6789010,6725303,1.362451625
410,2021-03-06,418,5,7514,356,65171,6664724,92047,1632,82901,6821942,6756771,1.362292728
411,2021-03-07,416,2,7622,306,66396,6684266,92463,1634,83207,6843125,6776729,1.364419324
412,2021-03-08,346,8,7705,255,67394,6701605,92809,1642,83462,6861808,6794414,1.365960332
413,2021-03-09,446,3,7721,427,70501,6739227,93255,1645,83889,6902983,6832482,1.364877361
414,2021-03-10,470,3,7776,412,70278,6774880,93725,1648,84301,6938883,6868605,1.364541999
415,2021-03-11,465,4,7873,364,68248,6814546,94190,1652,84665,6976984,6908736,1.363346349
416,2021-03-12,488,10,7284,1067,68738,6849247,94678,1662,85732,7012663,6943925,1.363465187
417,2021-03-13,490,5,6888,881,67874,6883739,95168,1667,86613,7046781,6978907,1.36365193
418,2021-03-14,459,2,6565,780,69843,6900930,95627,1669,87393,7066400,6996557,1.366772257
419,2021-03-15,379,6,6591,347,71590,6917343,96006,1675,87740,7084939,7013349,1.368903786
420,2021-03-16,363,3,6451,500,78044,6951663,96369,1678,88240,7126076,7048032,1.367317856
421,2021-03-17,469,8,6353,559,83462,6991209,96838,1686,88799,7171509,7088047,1.366215546
422,2021-03-18,445,2,6431,365,89722,7031081,97283,1688,89164,7218086,7128364,1.364731094
423,2021-03-19,463,2,6548,344,88341,7078853,97746,1690,89508,7264940,7176599,1.362010055
424,2021-03-20,447,3,6565,427,93018,7117738,98193,1693,89935,7308949,7215931,1.36078075
425,2021-03-21,456,3,6639,379,98308,7135756,98649,1696,90314,7332713,7234405,1.363609032
426,2021-03-22,415,1,6770,283,103132,7153767,99064,1697,90597,7355963,7252831,1.365866653
427,2021-03-23,346,7,6642,467,100172,7201407,99410,1704,91064,7400989,7300817,1.361628431
428,2021-03-24,428,3,6586,481,94326,7247045,99838,1707,91545,7441209,7346883,1.358916428
429,2021-03-25,430,2,6506,508,86983,7298607,100268,1709,92053,7485858,7398875,1.355178997
430,2021-03-26,489,7,6429,559,77409,7351235,100757,1716,92612,7529401,7451992,1.35208143
431,2021-03-27,505,5,6077,852,75174,7396130,101262,1721,93464,7572566,7497392,1.350629659
432,2021-03-28,482,1,6179,379,78605,7415245,101744,1722,93843,7595594,7516989,1.353520672
433,2021-03-29,382,4,6290,267,78938,7435264,102126,1726,94110,7616328,7537390,1.354925246
434,2021-03-30,447,3,6294,440,78424,7483000,102573,1729,94550,7663997,7585573,1.352211626
435,2021-03-31,506,2,6331,467,71302,7533417,103079,1731,95017,7707798,7636496,1.349820651
436,2021-04-01,551,4,6469,409,65659,7578012,103630,1735,95426,7747301,7681642,1.349060526
437,2021-04-02,557,2,6603,421,70752,7613354,104187,1737,95847,7788293,7717541,1.350002546
438,2021-04-03,543,3,6805,338,75288,7649581,104730,1740,96185,7829599,7754311,1.350603555
439,2021-04-04,543,4,6951,393,79799,7664402,105273,1744,96578,7849474,7769675,1.354921538
440,2021-04-05,473,4,7108,312,80497,7682575,105746,1748,96890,7868818,7788321,1.35775092
441,2021-04-06,477,4,7119,462,79155,7735910,106223,1752,97352,7921288,7842133,1.354516686
442,2021-04-07,668,4,7215,568,74642,7784632,106891,1756,97920,7966165,7891523,1.354504067
443,2021-04-08,700,2,7482,431,77994,7826834,107591,1758,98351,8012419,7934425,1.356002483
444,2021-04-09,671,6,7720,427,81912,7868937,108262,1764,98778,8059111,7977199,1.357143027
445,2021-04-10,677,1,7883,513,90014,7907675,108939,1765,99291,8106628,8016614,1.358915373
446,2021-04-11,614,3,7683,811,91909,7928068,109553,1768,100102,8129530,8037621,1.363002809
447,2021-04-12,587,2,7580,688,95248,7947393,110140,1770,100790,8152781,8057533,1.366919627
448,2021-04-13,542,5,7589,528,85584,8004251,110682,1775,101318,8200517,8114933,1.36392993
449,2021-04-14,731,7,7661,652,74627,8059346,111413,1782,101970,8245386,8170759,1.363557535
450,2021-04-15,698,6,7822,531,70221,8108792,112111,1788,102501,8291124,8220903,1.363730967
451,2021-04-16,673,2,7945,548,70883,8149664,112784,1790,103049,8333331,8262448,1.365019181
452,2021-04-17,658,4,8063,536,71039,8193297,113442,1794,103585,8377778,8306739,1.365662265
453,2021-04-18,671,3,8318,413,72191,8209761,114113,1797,103998,8396065,8323874,1.37091215
454,2021-04-19,532,4,8378,468,70763,8229412,114645,1801,104466,8414820,8344057,1.373971918
455,2021-04-20,549,1,8175,751,66590,8276807,115194,1802,105217,8458591,8392001,1.372664279
456,2021-04-21,731,4,8252,650,67211,8314457,115925,1806,105867,8497593,8430382,1.375085969
457,2021-04-22,735,2,8403,582,67139,8353705,116660,1808,106449,8537504,8470365,1.377272408
458,2021-04-23,797,3,8585,612,39939,8426133,117457,1811,107061,8583529,8543590,1.374796777
459,2021-04-24,785,1,8659,710,78269,8436411,118242,1812,107771,8632922,8554653,1.382195163
460,2021-04-25,644,1,8608,694,77560,8458344,118886,1813,108465,8654790,8577230,1.386065198
461,2021-04-26,499,4,8727,376,78084,8475508,119385,1817,108841,8672977,8594893,1.389022528
462,2021-04-27,512,3,8391,845,76508,8525203,119897,1820,109686,8721608,8645100,1.386878116
463,2021-04-28,769,1,8606,553,77166,8568664,120666,1821,110239,8766496,8689330,1.388668632
464,2021-04-29,679,4,8742,539,80392,8604041,121345,1825,110778,8805778,8725386,1.390712113
465,2021-04-30,661,3,8766,634,82511,8643774,122006,1828,111412,8848291,8765780,1.391844194
466,2021-05-01,627,3,8474,916,85212,8675542,122633,1831,112328,8883387,8798175,1.393845883
467,2021-05-02,606,2,8551,527,86607,8688387,123239,1833,112855,8898233,8811626,1.398595447
468,2021-05-03,488,1,8548,490,89022,8702576,123727,1834,113345,8915325,8826303,1.401798692
469,2021-05-04,541,6,8313,770,78096,8754790,124268,1840,114115,8957154,8879058,1.399562882
470,2021-05-05,676,7,8166,816,78995,8790129,124944,1847,114931,8994068,8915073,1.401491609
471,2021-05-06,574,4,8190,546,77055,8808418,125518,1851,115477,9010991,8933936,1.404957457
472,2021-05-07,525,9,8175,531,78896,8846414,126043,1860,116008,9051353,8972457,1.404776863
473,2021-05-08,701,5,8011,860,78259,8884162,126744,1865,116868,9089165,9010906,1.406562226
474,2021-05-09,564,9,8023,543,81280,8897182,127308,1874,117411,9105770,9024490,1.410694676
475,2021-05-10,463,1,8064,421,83398,8910889,127771,1875,117832,9122058,9038660,1.413605557
476,2021-05-11,510,4,7696,874,84628,8951374,128281,1879,118706,9164283,9079655,1.412840025
477,2021-05-12,634,5,7671,654,84279,8988344,128915,1884,119360,9201538,9117259,1.413966632
478,2021-05-13,715,7,7847,532,87517,9024005,129630,1891,119892,9241152,9153635,1.416158717
479,2021-05-14,747,2,8100,492,95208,9055705,130377,1893,120384,9281290,9186082,1.419288441
480,2021-05-15,681,3,7892,886,99216,9088819,131058,1896,121270,9319093,9219877,1.421472325
481,2021-05-16,610,4,8025,473,101663,9103282,131668,1900,121743,9336613,9234950,1.425757584
482,2021-05-17,619,3,8233,408,101804,9119208,132287,1903,122151,9353299,9251495,1.429898627
483,2021-05-18,528,1,8296,464,103413,9158775,132815,1904,122615,9395003,9291590,1.429410897
484,2021-05-19,654,8,8333,609,104494,9190680,133469,1912,123224,9428643,9324149,1.431433582
485,2021-05-20,646,4,8550,425,108873,9204369,134115,1916,123649,9447357,9338484,1.436153877
486,2021-05-21,561,6,8604,501,114144,9238287,134676,1922,124150,9487107,9372963,1.4368562
487,2021-05-22,666,4,8392,874,117558,9268065,135342,1926,125024,9520965,9403407,1.439286846
488,2021-05-23,585,5,8165,807,122235,9278136,135927,1931,125831,9536298,9414063,1.443871791
489,2021-05-24,530,3,8105,587,120704,9296451,136457,1934,126418,9553612,9432908,1.446605861
490,2021-05-25,516,4,8052,565,117098,9338655,136973,1938,126983,9592726,9475628,1.445529521
491,2021-05-26,705,2,8176,579,121069,9370708,137678,1940,127562,9629455,9508386,1.447963934
492,2021-05-27,629,3,8195,607,122659,9404724,138307,1943,128169,9665690,9543031,1.449298446
493,2021-05-28,587,3,8198,581,122872,9440687,138894,1946,128750,9702453,9579581,1.449896399
494,2021-05-29,533,5,7745,981,123790,9470371,139427,1951,129731,9733588,9609798,1.450883775
495,2021-05-30,480,6,7576,643,126493,9481212,139907,1957,130374,9747612,9621119,1.454165571
496,2021-05-31,430,2,7561,443,127953,9492866,140337,1959,130817,9761156,9633203,1.4568051768
497,2021-06-01,459,4,7376,640,127612,9529992,140796,1963,131457,9798400,9670788,1.455889634
498,2021-06-02,677,2,7447,604,128917,9563958,141473,1965,132061,9834348,9705431,1.457668392
499,2021-06-03,681,3,7496,629,129822,9600346,142154,1968,132690,9872322,9742500,1.459112138
500,2021-06-04,695,1,7602,588,133844,9634629,142849,1969,133278,9911322,9777478,1.461000475
501,2021-06-05,744,2,7867,477,137164,9665195,143593,1971,133755,9945952,9808788,1.463921944
502,2021-06-06,556,2,7922,499,136465,9679081,144149,1973,134254,9959695,9823230,1.467429756
503,2021-06-07,485,1,7808,598,136526,9691135,144634,1974,134852,9972295,9835769,1.470490004
504,2021-06-08,454,1,7709,552,139260,9724234,145088,1975,135404,10008582,9869322,1.470090853
505,2021-06-09,602,2,7547,762,131424,9767668,145690,1977,136166,10044782,9913358,1.469633196
506,2021-06-10,610,2,7616,539,130327,9800234,146300,1979,136705,10076861,9946534,1.470864122
507,2021-06-11,556,2,7658,512,133753,9830454,146856,1981,137217,10111063,9977310,1.471899741
508,2021-06-12,565,1,7409,813,122200,9870913,147421,1982,138030,10140534,10018334,1.47151213
509,2021-06-13,452,3,7316,542,124517,9880516,147873,1985,138572,10152906,10028389,1.474543917
510,2021-06-14,399,3,7269,443,123424,9893800,148272,1988,139015,10165496,10042072,1.476508035
511,2021-06-15,373,4,6927,711,123664,9924159,148645,1992,139726,10196468,10072804,1.475706268
512,2021-06-16,545,1,6766,705,118764,9961429,149190,1993,140431,10229383,10110619,1.475577311
513,2021-06-17,540,1,6714,591,121319,9986786,149730,1994,141022,10257835,10136516,1.477134747
514,2021-06-18,507,2,6432,787,125837,10017973,150237,1996,141809,10294047,10168210,1.477516692
515,2021-06-19,482,1,6343,570,128721,10043713,150719,1997,142379,10323153,10194432,1.478444312
516,2021-06-20,429,5,6259,508,131062,10053423,151148,2002,142887,10335633,10204571,1.481179366
517,2021-06-21,357,2,6244,370,128433,10066108,151505,2004,143257,10346046,10217613,1.48278272
518,2021-06-22,394,2,6082,554,127127,10101016,151899,2006,143811,10380042,10252915,1.481520134
519,2021-06-23,645,1,6164,562,129791,10127613,152544,2007,144373,10409948,10280157,1.483868388
520,2021-06-24,610,1,6363,410,120971,10164656,153154,2008,144783,10438781,10317810,1.484365384
521,2021-06-25,634,1,6394,602,122188,10190568,153788,2009,145385,10466544,10344356,1.486685106
522,2021-06-26,668,3,6458,601,114573,10226486,154456,2012,145986,10495515,10380942,1.487880387
523,2021-06-27,614,1,6720,351,116376,10237231,155070,2013,146337,10508677,10392301,1.492162323
524,2021-06-28,501,2,6884,335,114843,10250514,155571,2015,146672,10520928,10406085,1.495000281
525,2021-06-29,595,2,7074,403,116858,10282716,156166,2017,147075,10555740,10438882,1.496003116
526,2021-06-30,794,1,7250,617,114110,10308001,156960,2018,147692,10579071,10464961,1.499862255
527,2021-07-01,761,3,7676,332,124925,10331669,157721,2021,148024,10614315,10489390,1.503624138
528,2021-07-02,825,3,8204,294,130666,10352389,158546,2024,148318,10641601,10510935,1.508391023
529,2021-07-03,794,1,8184,813,133909,10377367,159340,2025,149131,10670616,10536707,1.512237172
530,2021-07-04,743,1,8444,482,136297,10388744,160083,2026,149613,10685124,10548827,1.517543135
531,2021-07-05,711,2,8723,430,134893,10404446,160794,2028,150043,10700133,10565240,1.521915262
532,2021-07-06,746,4,8749,716,141699,10432476,161540,2032,150759,10735715,10594016,1.52482307
533,2021-07-07,1211,1,9218,741,142748,10461001,162751,2033,151500,10766500,10623752,1.531954059
534,2021-07-08,1275,1,10069,423,151158,10487596,164026,2034,151923,10802780,10651622,1.539915705
535,2021-07-09,1316,2,10808,575,160468,10518405,165342,2036,152498,10844215,10683747,1.547603102
536,2021-07-10,1378,2,11529,655,169719,10545199,166720,2038,153153,10881638,10711919,1.556397131
537,2021-07-11,1324,5,12241,607,176062,10558170,168044,2043,153760,10902276,10726214,1.566666486
538,2021-07-12,1100,1,12775,565,174671,10576081,169144,2044,154325,10919896,10745225,1.574131766
539,2021-07-13,1150,2,13183,740,179130,10614873,170294,2046,155065,10964297,10785167,1.578964888
540,2021-07-14,1613,2,13775,1019,181905,10655045,171907,2048,156084,11008857,10826952,1.587769115
541,2021-07-15,1599,2,14770,602,204479,10682469,173506,2050,156686,11060454,10855975,1.598253496
542,2021-07-16,1535,1,15457,847,218192,10715349,175041,2051,157533,11108582,10890390,1.60729781
543,2021-07-17,1449,4,15907,995,227636,10745097,176490,2055,158528,11149223,10921587,1.615973942
544,2021-07-18,1453,2,16683,675,265438,10732596,177943,2057,159203,11175977,10910539,1.630927675
545,2021-07-19,1251,1,17216,717,240689,10782546,179194,2058,159920,11202429,10961740,1.634722225
546,2021-07-20,1278,1,17206,1287,244671,10826839,180472,2059,161207,11251982,11007311,1.639564831
547,2021-07-21,1781,1,17546,1440,252187,10864229,182253,2060,162647,11298669,11046482,1.649873688
548,2021-07-22,1841,3,18251,1133,269496,10890323,184094,2063,163780,11343913,11074417,1.662335814
549,2021-07-23,1629,3,18838,1039,278011,10924565,185723,2066,164819,11388299,11110288,1.671630834
550,2021-07-24,1627,2,19335,1128,274697,10968471,187350,2068,165947,11430518,11155821,1.67939231
551,2021-07-25,1487,5,20725,92,274761,10989742,188837,2073,166039,11453340,11178579,1.689275533
552,2021-07-26,1318,4,20776,1263,281003,11001181,190155,2077,167302,11472339,11191336,1.699126896
553,2021-07-27,1363,2,20273,1864,309414,11027670,191518,2079,169166,11528602,11219188,1.707057587
554,2021-07-28,1895,4,21100,1064,323954,11068240,193413,2083,170230,11585607,11261653,1.717447696
555,2021-07-29,1673,2,21573,1198,342326,11100088,195086,2085,171428,11637500,11295174,1.727162415
556,2021-07-30,1710,4,21860,1419,357215,11128951,196796,2089,172847,11682962,11325747,1.737598412
557,2021-07-31,1538,6,21898,1494,369201,11161280,198334,2095,174341,11728815,11359614,1.745957213
558,2021-08-01,1442,3,22411,926,378600,11173404,199776,2098,175267,11751780,11373180,1.756553576
559,2021-08-02,1218,1,22323,1305,387170,11184435,200994,2099,176572,11772599,11385429,1.765361674
560,2021-08-03,1200,5,22300,1218,368300,11249517,202194,2104,177790,11820011,11451711,1.765622622
561,2021-08-04,1725,2,22425,1598,397889,11262432,203919,2106,179388,11864240,11466351,1.77841233
562,2021-08-05,1775,3,22863,1334,415489,11287247,205694,2109,180722,11908430,11492941,1.789742069
563,2021-08-06,1704,4,22828,1735,427050,11317198,207398,2113,182457,11951646,11524596,1.799611891
564,2021-08-07,1823,3,23435,1213,444937,11341765,209221,2116,183670,11995923,11550986,1.811282604
565,2021-08-08,1727,5,23840,1317,466279,11350210,210948,2121,184987,12027437,11561158,1.8246269102
566,2021-08-09,1491,4,24088,1239,467508,11377877,212439,2125,186226,12057824,11590316,1.8329008458
567,2021-08-10,1537,9,24334,1282,465922,11432181,213976,2134,187508,12112079,11646157,1.8373099383
568,2021-08-11,2221,1,24571,1983,488067,11451928,216197,2135,189491,12156192,11668125,1.8528855321
569,2021-08-12,1987,3,25527,1028,510096,11478755,218184,2138,190519,12207035,11696939,1.8653085221
570,2021-08-13,1989,6,25794,1716,539535,11498251,220173,2144,192235,12257959,11718424,1.8788618674
571,2021-08-14,1928,4,26187,1531,562705,11524467,222101,2148,193766,12309273,11746568,1.8907735433
572,2021-08-15,1816,8,26670,1325,585131,11535663,223917,2156,195091,12344711,11759580,1.9041241268
573,2021-08-16,1554,11,27118,1095,595225,11552073,225471,2167,196186,12372769,11777544,1.9144144144
574,2021-08-17,1372,6,27459,1025,320680,11857446,226843,2173,197211,12404969,12084289,1.8771729143
575,2021-08-18,1803,5,26904,2353,634727,11598303,228646,2178,199564,12461676,11826949,1.9332627544
576,2021-08-19,2152,13,27394,1649,652740,11635157,230798,2191,201213,12518695,11865955,1.9450436142
577,2021-08-20,2140,6,27987,1541,659590,11674562,232938,2197,202754,12567090,11907500,1.9562292672
578,2021-08-21,1787,5,28025,1744,667998,11729868,234725,2202,204498,12632591,11964593,1.9618302101
579,2021-08-22,1626,13,27879,1759,678447,11749534,236351,2215,206257,12664332,11985885,1.9719111271
580,2021-08-23,1417,7,27962,1327,689243,11767007,237768,2222,207584,12694018,12004775,1.9806118815
581,2021-08-24,1507,6,27873,1590,688192,11822284,239275,2228,209174,12749751,12061559,1.9837816985
582,2021-08-25,2154,9,28038,1980,697586,11867593,241429,2237,211154,12806608,12109022,1.9937943791
583,2021-08-26,1882,20,28194,1706,710599,11912887,243311,2257,212860,12866797,12156198,2.0015386389
584,2021-08-27,1837,8,28224,1799,718479,11964162,245148,2265,214659,12927789,12209310,2.007877595
585,2021-08-28,1791,11,27689,2315,743177,11993370,246939,2276,216974,12983486,12240309,2.0174245601
586,2021-08-29,1619,3,27566,1739,762594,12004769,248558,2279,218713,13015921,12253327,2.0284939755
587,2021-08-30,1485,5,27413,1633,766807,12032828,250043,2284,220346,13049678,12282871,2.0357048445
588,2021-08-31,1370,1,27440,1342,751241,12092057,251413,2285,221688,13094711,12343470,2.0368097463
589,2021-09-01,2024,7,26840,2617,780979,12117724,253437,2292,224305,13152140,12371161,2.0486112823
590,2021-09-02,1960,11,26888,1901,819939,12148175,255397,2303,226206,13223511,12403572,2.0590600836
591,2021-09-03,1708,5,26194,2397,825198,12204374,257105,2308,228603,13286677,12461479,2.0631981163
592,2021-09-04,1803,7,26203,1787,850535,12240913,258908,2315,230390,13350356,12499821,2.0712936609
593,2021-09-05,1490,6,25760,1927,874694,12247641,260398,2321,232317,13382733,12508039,2.0818451237
594,2021-09-06,1375,6,25768,1361,891318,12263652,261773,2327,233678,13416743,12525425,2.0899330761
595,2021-09-07,1597,3,25831,1531,886983,12318059,263370,2330,235209,13468412,12581429,2.0933234213
596,2021-09-08,2047,4,25813,2061,898494,12355753,265417,2334,237270,13519664,12621170,2.1029508357
597,2021-09-09,2049,9,26222,1631,897924,12403479,267466,2343,238901,13568869,12670945,2.1108607132
598,2021-09-10,1893,5,26295,1815,888674,12457022,269359,2348,240716,13615055,12726381,2.1165404367
599,2021-09-11,1864,10,25921,2228,895077,12499160,271223,2358,242944,13665460,12770383,2.1238438972
600,2021-09-12,1755,1,26174,1501,910419,12520776,272978,2359,244445,13704173,12793754,2.133681795
601,2021-09-13,1433,1,26560,1046,925739,12535590,274411,2360,245491,13735740,12810001,2.1421622059
602,2021-09-14,1508,7,25905,2156,914400,12599920,275919,2367,247647,13790239,12875839,2.1429205506
603,2021-09-15,2065,13,25784,2173,914120,12646983,277984,2380,249820,13839087,12924967,2.1507521063
604,2021-09-16,1942,6,25512,2208,920101,12690472,279926,2386,252028,13890499,12970398,2.1581912906
605,2021-09-17,2008,3,25467,2050,921233,12735788,281934,2389,254078,13938955,13017722,2.1657706317
606,2021-09-18,2087,5,25615,1934,917857,12784737,284021,2394,256012,13986615,13068758,2.1732822659
607,2021-09-19,1909,9,26080,1435,932234,12802334,285930,2403,257447,14020498,13088264,2.1846289164
608,2021-09-20,1604,6,26117,1561,953532,12809908,287534,2409,259008,14050974,13097442,2.1953447092
609,2021-09-21,1729,4,26762,1080,965875,12826146,289263,2413,260088,14081284,13115409,2.2055202395
610,2021-09-22,1720,6,26754,1722,997996,12823456,290983,2419,261810,14112435,13114439,2.2187986844
611,2021-09-23,1715,8,27431,1030,1034720,12823651,292698,2427,262840,14151069,13116349,2.2315508683
612,2021-09-24,2429,7,28203,1650,1030500,12896055,295127,2434,264490,14221682,13191182,2.2373051937
613,2021-09-25,3270,7,29545,1921,1056223,12930717,298397,2441,266411,14285337,13229114,2.2556083498
614,2021-09-26,2768,9,30575,1729,1096862,12927905,301165,2450,268140,14325932,13229070,2.2765394695
615,2021-09-27,2381,6,31958,992,1120111,12942271,303546,2456,269132,14365928,13245817,2.2916366729
616,2021-09-28,2288,8,32442,1796,1135394,12984337,305834,2464,270928,14425565,13290171,2.3012044013
617,2021-09-29,2881,10,33517,1796,1137617,13038919,308715,2474,272724,14485251,13347634,2.3128818186
618,2021-09-30,2561,7,34590,1481,1149658,13083312,311276,2481,274205,14544246,13394588,2.3238937994
619,2021-10-01,2484,16,35687,1371,1169025,13113426,313760,2497,275576,14596211,13427186,2.3367517214
620,2021-10-02,2247,7,36411,1516,1179529,13149149,316007,2504,277092,14644685,13465156,2.3468498991
621,2021-10-03,2085,3,36738,1755,1202878,13154145,318092,2507,278847,14675115,13472237,2.3610926678
622,2021-10-04,1670,6,34580,3822,1216193,13165256,319762,2513,282669,14701211,13485018,2.3712389557
623,2021-10-05,1574,11,34615,1528,1228509,13181782,321336,2524,284197,14731627,13503118,2.3797170401
624,2021-10-06,2027,12,33787,2843,1219801,13237774,323363,2536,287040,14780938,13561137,2.384482953
625,2021-10-07,2425,8,34422,1782,1239741,13268436,325788,2544,288822,14833965,13594224,2.3965178152
626,2021-10-08,2171,10,33314,3269,1232857,13321370,327959,2554,292091,14882186,13649329,2.4027481497
627,2021-10-09,1953,6,32423,2838,1247124,13348827,329912,2560,294929,14925863,13678739,2.4118597481
628,2021-10-10,1594,15,32223,1779,1261712,13358428,331506,2575,296708,14951646,13689934,2.4215310314
629,2021-10-11,1297,8,32198,1314,1255745,13388859,332803,2583,298022,14977407,13721662,2.4253840387
630,2021-10-12,1346,11,32295,1238,1276809,13396614,334149,2594,299260,15007572,13730763,2.4335792555
631,2021-10-13,1583,11,31061,2806,1285868,13440812,335732,2605,302066,15062412,13776544,2.436982744
632,2021-10-14,1939,13,31334,1653,1296534,13472155,337671,2618,303719,15106360,13809826,2.4451502864
633,2021-10-15,1683,8,30877,2132,1309168,13503999,339354,2626,305851,15152521,13843353,2.4513858745
634,2021-10-16,1617,18,30140,2336,1293233,13563983,340971,2644,308187,15198187,13904954,2.4521548219
635,2021-10-17,1420,16,29387,2157,1312433,13566040,342391,2660,310344,15220864,13908431,2.4617514369
636,2021-10-18,1050,8,28992,1437,1320566,13582339,343441,2668,311781,15246346,13925780,2.466224513
637,2021-10-19,1073,21,28393,1651,1323771,13628545,344514,2689,313432,15296830,13973059,2.4655589015
638,2021-10-20,1571,9,26780,3175,1325132,13673512,346085,2698,316607,15344729,14019597,2.4685802309
639,2021-10-21,1441,11,27062,1148,1334586,13709892,347526,2709,317755,15392004,14057418,2.4721894162
640,2021-10-22,1438,16,25922,2562,1327170,13761248,348964,2725,320317,15437382,14110212,2.4731308076
641,2021-10-23,1508,20,25191,2219,1339287,13791710,350472,2745,322536,15481469,14142182,2.4782031513
642,2021-10-24,1421,21,25734,857,1354359,13798727,351893,2766,323393,15504979,14150620,2.4867673642
643,2021-10-25,1190,7,25862,1055,1368282,13809107,353083,2773,324448,15530472,14162190,2.4931384199
644,2021-10-26,1272,15,23975,3144,1366840,13858235,354355,2788,327592,15579430,14212590,2.4932471843
645,2021-10-27,1945,9,23845,2066,1387186,13884820,356300,2797,329658,15628306,14241120,2.5019099621
646,2021-10-28,2111,11,24750,1195,1389130,13930645,358411,2808,330853,15678186,14289056,2.5082902607
647,2021-10-29,2124,9,24723,2142,1358692,14011558,360535,2817,332995,15730785,14372093,2.5085768649
648,2021-10-30,2104,13,25228,1586,1366434,14046627,362639,2830,334581,15775700,14409266,2.5167069578
649,2021-10-31,2061,19,25303,1967,1386962,14052403,364700,2849,336548,15804065,14417103,2.529634421
650,2021-11-01,1685,9,26174,805,1424100,14058818,366385,2858,337353,15849303,14425203,2.5398949325
